*########*
*###*####*
**#######*
*###*####*
#######*#*
#########*
#*****###*
#*###*###*
#***#*###*
#####*###*